Welcome to The Field
7,7,4,2,5,2
1,1,1,1,1,1,1
1,0,0,0,0,1,1
1,0,1,0,0,0,1
1,0,0,0,1,1,1
1,0,0,0,0,0,1
1,1,0,1,0,9,1
1,1,1,1,1,1,1