Good Luck With Exam
9,9,7,3,3,3
1,1,1,1,1,1,1,1,1
1,1,0,0,0,0,0,1,1
1,0,0,1,1,0,0,0,1
1,0,0,0,0,0,1,0,1
1,1,0,1,1,0,1,0,1
1,0,0,0,1,1,1,0,1
1,0,1,1,1,0,0,0,1
1,0,0,0,0,9,1,1,1
1,1,1,1,1,1,1,1,1